WWWWWWWWWWWWWWWWWWWWWWWWWWWWWWWWWWWWWWWW
W..X.......rrr.....WWWWWWWWWWWWWWWWWWWWW
W..........rrr.....WWWWWWWWWWWWWWWWWWWWW
W..................WWWWWWWWWWWWWWWWWWWWW
W..........mmm.....WWWWWWWWWWWWWWWWWWWWW
W.......r..   .....WWWWWWWWWWWWWWWWWWWWW
W........r.   .....WWWWWWWWWWWWWWWWWWWWW
W.........r   .....WWWWWWWWWWWWWWWWWWWWW
W........P.mmm.....WWWWWWWWWWWWWWWWWWWWW
W..........   .....WWWWWWWWWWWWWWWWWWWWW
W..........   .....WWWWWWWWWWWWWWWWWWWWW
WWWWWWWWWWWWWWWWWWWWWWWWWWWWWWWWWWWWWWWW
WWWWWWWWWWWWWWWWWWWWWWWWWWWWWWWWWWWWWWWW
WWWWWWWWWWWWWWWWWWWWWWWWWWWWWWWWWWWWWWWW
WWWWWWWWWWWWWWWWWWWWWWWWWWWWWWWWWWWWWWWW
WWWWWWWWWWWWWWWWWWWWWWWWWWWWWWWWWWWWWWWW
WWWWWWWWWWWWWWWWWWWWWWWWWWWWWWWWWWWWWWWW
WWWWWWWWWWWWWWWWWWWWWWWWWWWWWWWWWWWWWWWW
WWWWWWWWWWWWWWWWWWWWWWWWWWWWWWWWWWWWWWWW
WWWWWWWWWWWWWWWWWWWWWWWWWWWWWWWWWWWWWWWW
WWWWWWWWWWWWWWWWWWWWWWWWWWWWWWWWWWWWWWWW
WWWWWWWWWWWWWWWWWWWWWWWWWWWWWWWWWWWWWWWW
