WWWWWWWWWWWWWWWWWWWWWWWWWWWWWWWWWWWWWWWW
Wrq...............rWWWWWWWWWWWWWWWWWWWWW
WXrq.............rPWWWWWWWWWWWWWWWWWWWWW
Wd.rq...........r.dWWWWWWWWWWWWWWWWWWWWW
Wrd.rq.........r.drWWWWWWWWWWWWWWWWWWWWW
W.rd.rq.......r.dr.WWWWWWWWWWWWWWWWWWWWW
W..rd.rq.....r.dr..WWWWWWWWWWWWWWWWWWWWW
W...rd.rq...r.dr...WWWWWWWWWWWWWWWWWWWWW
W....rd.rq.r.dr....WWWWWWWWWWWWWWWWWWWWW
W.....rd.rr.dr.....WWWWWWWWWWWWWWWWWWWWW
W......rd..dr......WWWWWWWWWWWWWWWWWWWWW
WWWWWWWWWWWWWWWWWWWWWWWWWWWWWWWWWWWWWWWW
WWWWWWWWWWWWWWWWWWWWWWWWWWWWWWWWWWWWWWWW
WWWWWWWWWWWWWWWWWWWWWWWWWWWWWWWWWWWWWWWW
WWWWWWWWWWWWWWWWWWWWWWWWWWWWWWWWWWWWWWWW
WWWWWWWWWWWWWWWWWWWWWWWWWWWWWWWWWWWWWWWW
WWWWWWWWWWWWWWWWWWWWWWWWWWWWWWWWWWWWWWWW
WWWWWWWWWWWWWWWWWWWWWWWWWWWWWWWWWWWWWWWW
WWWWWWWWWWWWWWWWWWWWWWWWWWWWWWWWWWWWWWWW
WWWWWWWWWWWWWWWWWWWWWWWWWWWWWWWWWWWWWWWW
WWWWWWWWWWWWWWWWWWWWWWWWWWWWWWWWWWWWWWWW
WWWWWWWWWWWWWWWWWWWWWWWWWWWWWWWWWWWWWWWW

















