WWWWW
Wr rW
Wr rW
Wr rW
WW WW
WW WW
WW WW
WW WW
WW WW
WW WW
WW WW
WW WW
WW WW
WW WW
WW WW
WW WW
WW WW
WW WW
WW WW